11111111111111111
1C000001110000001
1111P011110111111
10000100000000001
1110000C111011111
10000111101000001
1E010000101111111
11111111111111111