1111111111111111111111111
1P000000000000000000000C1
100000011111E1111111111W1
1010000011110111111111111
1010111010000000000000001
1000111010W11111111111101
1011111010000000001111101
101C1000111111111010C0001
1010111111000000101011111
1010000001011110101011111
1111111101C00010001000001
1000000001011011111111101
1011111111011011111111101
1000110001011000000000001
1110110101011011111111111
1000110101011000000000001
1000110101011111111111101
10001101010000000C0001101
1000110101111111111101101
1C000001000000C0000001101
1111111111111111111111111