1111111111111111111111111
1P00000000000000000000001
101111111111E1111111111C1
1010000011110111111111111
1010111010000000000000001
1000111010111111111111101
1011111010000000001111101
101C1000111111111010000C1
1010111111000000101011111
1010000001011110101011111
1111111101C00010001000001
1000000001011011111111101
1011111111011011111111101
1000110001011000000000001
1110110101011011111111111
1000110101011000000000001
1010110101011111111111101
10101101010000000C0001101
1010110101111111111101101
1C100001000000C0000001101
1111111111111111111111111