1111111111111111111111111111111
1000000000001100000C00010000P01
10010000C0001100000110010C00001
1001000000001100000110010000001
1001000000011001000110000011111
1001C00000000001100110000011111
1001111001100C01000110000000001
10E0000000110001000111111000001
100000000011000110000000C000001
10000000000C0001110001100000001
1111111111111111111111111111111