1111111111111111111111111111111111111111
1000000000000000000000000000P00000000001
1000000000000000000010000C00000000000001
1000000W00000000000010000000000000000001
1000000000000000000010000W00000000000001
1000C0000000W000000010000000000000000001
1000000000000000000010000000000000000001
1000000000000000000011000000000000000001
10E0000W00000000000000000000000000000001
100000000000000000000000C000000000000001
100000000000000000000000C000000000000001
100000000000000000000000C000000000000001
100000000000000000000000C000000000000001
100000000000000000000000C000000000000001
100000000000000000000000C000000000000001
100000000000000000000000C000000000000001
100000000000000000000000C000000000000001
100000000000000000000000C000000000000001
100000000000000000000000C000000000000001
1111111111111111111111111111111111111111