1111111111111111111111111111111
1000000000000000000000000000P01
1000000000000000000010000C00001
1000000W00000000000010000000001
1000000000000000000010000W00001
1000C0000000W000000010000000001
1000000000000000000010000000001
10E0000000000000000011000000001
1000000W0000000000000000C000001
1000000000000000000000000000001
1111111111111111111111111111111