1111111111111
10010000000C1
10W0C111110W1
1P0011E000001
1111111111111