1111111111111111111111111111111111111111
1C1110000000C000000110000000001100000001
101C111111000000000110010000001110000001
1010100011000000111110000000C00110001001
1010100011000000000110001110000110000001
10000000110000000001100C0000000000011111
1111100000000000000110000000000000011111
111110000000000000011110000C0000000000C1
10E000000000C0000000000000000000100C0P01
1000000000000000000000000000010000000001
111110000000000000000000000C000000011111
1111100000111000000011111110000000011111
1000000001011000000100000001000000000001
1000C00010011000001000000011000000000001
10000001000110000C0000001100010000010001
1000001000011000000000110000111000000001
1000011111111000000011000000010000000001
1000000000011000001100000011000000111111
1000C000000110000011111111110001C1111111
1111111111111111111111111111111111111111