111111111
1C0000W11
1111P0111
100001001
1110000C1
100001111
1E0100001
111111111