111111111
1C0000011
111101011
1001C1P11
1E0001111
111111111