11111111111111111
1P01C011111111111
10000000000C00111
10010001111110001
100100011111111E1
10010001111111101
1C01000111C000001
11111111111111111