11111111
1W010001
100C0001
1P0000E1
11111111
11111111
11111111
11111111