11111111111111111
1P01C011111111111
100000000000000C1
10010001111111111
10010001111111111
10010001111111111
100100E1111111111
11111111111111111